{
    "af": "afr",
    "als": "gsw",
    "am": "amh",
    "an": "arg",
    "ar": "arb",
    "arz": "arz",
    "as": "asm",
    "ast": "ast",
    "av": "ava",
    "az": "aze",
    "azb": "azb",
    "ba": "bak",
    "bar": "bar",
    "bcl": "bcl",
    "be": "bel",
    "bg": "bul",
    "bh": "",
    "bn": "ben",
    "bo": "bod",
    "bpy": "bpy",
    "br": "bre",
    "bs": "bos",
    "bxr": "bxr",
    "ca": "cat",
    "cbk": "cbk",
    "ce": "che",
    "ceb": "ceb",
    "ckb": "ckb",
    "cs": "ces",
    "cv": "chv",
    "cy": "cym",
    "da": "dan",
    "de": "deu",
    "dsb": "dsb",
    "dv": "div",
    "el": "ell",
    "eml": "eml",
    "en": "eng",
    "eo": "epo",
    "es": "spa",
    "et": "est",
    "eu": "eus",
    "fa": "fas",
    "fi": "fin",
    "fr": "fra",
    "frr": "frr",
    "fy": "fry",
    "ga": "gle",
    "gd": "gla",
    "gl": "glg",
    "gn": "grn",
    "gom": "gom",
    "gu": "guj",
    "he": "heb",
    "hi": "hin",
    "hr": "hrv",
    "hsb": "hsb",
    "ht": "hat",
    "hu": "hun",
    "hy": "hye",
    "ia": "ina",
    "id": "ind",
    "ie": "ile",
    "ilo": "ilo",
    "io": "ido",
    "is": "isl",
    "it": "ita",
    "ja": "jpn",
    "jbo": "jbo",
    "jv": "jav",
    "ka": "kat",
    "kk": "kaz",
    "km": "khm",
    "kn": "kan",
    "ko": "kor",
    "krc": "krc",
    "ku": "kur",
    "kv": "kom",
    "kw": "cor",
    "ky": "kir",
    "la": "lat",
    "lb": "ltz",
    "lez": "lez",
    "li": "lim",
    "lmo": "lmo",
    "lo": "lao",
    "lrc": "lrc",
    "lt": "lit",
    "lv": "lav",
    "mai": "mai",
    "mg": "mlg",
    "mhr": "mhr",
    "min": "min",
    "mk": "mkd",
    "ml": "mal",
    "mn": "mon",
    "mr": "mar",
    "mrj": "mrj",
    "ms": "msa",
    "mt": "mlt",
    "mwl": "mwl",
    "my": "mya",
    "myv": "myv",
    "mzn": "mzn",
    "nah": "",
    "nap": "nap",
    "nds": "nds",
    "ne": "nep",
    "new": "new",
    "nl": "nld",
    "nn": "nno",
    "no": "nor",
    "oc": "oci",
    "or": "ory",
    "os": "oss",
    "pa": "pan",
    "pam": "pam",
    "pl": "pol",
    "pms": "pms",
    "pnb": "pnb",
    "ps": "pus",
    "pt": "por",
    "qu": "que",
    "rm": "roh",
    "ro": "ron",
    "ru": "rus",
    "rue": "rue",
    "sa": "san",
    "sah": "sah",
    "scn": "scn",
    "sd": "snd",
    "sh": "rsb",
    "si": "sin",
    "sk": "slk",
    "sl": "slv",
    "so": "som",
    "sq": "sqi",
    "sr": "srp",
    "su": "sun",
    "sv": "swe",
    "sw": "swa",
    "ta": "tam",
    "te": "tel",
    "tg": "tgk",
    "th": "tha",
    "tk": "tuk",
    "tl": "fil",
    "tr": "tur",
    "tt": "tat",
    "tyv": "tyv",
    "ug": "uig",
    "uk": "ukr",
    "ur": "urd",
    "uz": "uzb",
    "vec": "vec",
    "vi": "vie",
    "vls": "vls",
    "vo": "vol",
    "wa": "wln",
    "war": "war",
    "wuu": "wuu",
    "xal": "xal",
    "xmf": "xmf",
    "yi": "yid",
    "yo": "yor",
    "yue": "yue",
    "zh": "zho"
  }  